NO ./textures/north.png
EA ./textures/east.png
SO ./textures/south.png
WE ./textures/west.png

F 255,255,255
C 0,255,0

        1111111111111111111111111
        1000000000110000000000001
        1011000001110000000000111
        10010000000000000000001
1111111110110000011100000000101
1000000000110000011101111111111
11110111111111011100000010001
11110111111111011101010010001
11000000000101011100000010001
10000000100000001100000010001
10000000000000001101010010001
110000N0110101011111011110011
11110111 1110101 101111010001
11111111 1111111 111111111111
