
sadasdasdasd

NO ./textures/north.png
EA ./textures/east.png
SO ./textures/south.png
WE ./textures/west.png

F 254, 1,219
C 255,255,255

        1111111111111111111111111
        1000000000110000000000001
        1011000001110000000000111
        10010000000000000000001
1111111110110000011100000000101
1000000000110000011101111111111
11110111111111011100000010001
11110111111111011101010010001
11000000000101011100000010001
10000000100000001100000010001
10000000000000001101010010001
110000N111010101111101111001111
11110111 1110101 101111010001
11111111 1111111 111111111111
				 1
