NO ./../textures/north_texture
SO ./../textures/south_texture
WE ./../textures/west_texture
EA ./../textures/east_texture
    
F 220,100,0
C

11111111111111111111
10000000010000100001
10111100000000000011
10000000110001110111
10111000010001110001
10101000010001110101
100010000W0000000011
11111111111111111111