EA ./textures/east.png
NO ./textures/north.png
SO ./textures/south.png
WE ./textures/west.png

C 255,255,255
F 255,255,0

                1111111111111111111111111111111111111111
                1000000001000010000100000000000000000001
                1011110000000000001100000000111111110001
11111111111111111000000011000111011100000000100000010001
10111000010001110001000000001000111100011111111111111111
1010100001000111010100000000000010000001
1000100000000000001100100010101111111101
1000100011110000000000111011000100000101
100010001001000000110W001000100100100101
1000100010010000001100001000000100111101
1000100010010000001100001111111100000001
1111111111111111111111111111111111111111