NO ./textures/north.png
EA ./textures/east.png
SO ./textures/south.png
WE ./textures/west.png

F 130, 128, 111
C 111, 127, 144

1111111111
1000001001
1000N01001
1001001001
1001100001
1001000001
1001000111
1111111111


1111111111
1000001001
1000001001
1001001001
1001100001
1001000001
1001000111
1111111111

1111111111
1000001001
1000001001
1001001001
1001100001
1001000001
1001000111
1111111111

1111111111
1000001001
1000001001
1001001001
1001100001
1001000001
1001000111
1111111111

1111111111
1000001001
1000001001
1001001001
1001100001
1001000001
1001000111
1111111111
